S C . . . . . . # #
C C . . . # # # . .
. # . # . . . . . .
. # . . . . . . . .
. . # # . . . . # .
. # . . . . C . . .
. . # . # . . . # .
. . . . . . . # . .
. . C . . . . # . .
. . . . . . . . L T