S L . . . . . C . . . . . . .
L . C . # . . . . . # . . . .
. . . . . . . . . # . . . # #
. C . # . . # # . . # . # . .
. . . # . . # . . . # . . . .
. . . . . . # # . . . . . . .
. . . . . # # . # . . . # . .
. . # . . . . C . . . # . . .
. . . . . # . . # . # . # . .
. # . . . . . . # . . . . . .
. . # . . # # . . . . # . # .
. . # . . . . # # . . . . . .
. . # . . # . # . . # . . . .
. . . . . . # . . . # C . # L
. . C . . . # . . . . . . L T